################
#              #
#      $       #
#  $$  $  $$$  #
#              #
# $$$$$$$$$$$$ #
#              #
#              #
#  $$$$        #
#        $$$$  #
#              #
#              #
# $$$$$$$$$$$$ #
#              #
#      $       #
#  $$  $  $$$  #
#              #
################
