################
#@             #
#      $       #
#  $$  $  $$$  #
#              #
# $$$$$$$$$$$$ #
#              #
#              #
#  $$$$        #
#        $$$$  #
#              #
#              #
# $$$$$$$$$$$$ #
#              #
#      $       #
#  $$  $  $$$  #
#             %#
################
