################
#       %      #
#  $  $##$  $  #
# $#  $  $  #$ #
#              #
#              #
#  $ $$##$$ $  #
#  $ #    # $  #
#  #   @    #  #
#  #        #  #
#  $ #    # $  #
#  $ $$##$$ $  #
#              #
#              #
# $#  $  $  #$ #
#  $  $##$  $  #
#      %       #
################

