################
#@ #        #% #
#  #        #  #
#  $        $  #
#              #
#     $  $     #
#    $    $    #
###$        $###
#      $$     %#
#%     $$      #
###$        $###
#    $    $    #
#     $  $     #
#              #
#  $        $  #
#  #        #  #
#% #        #% #
################
